1 19 10933 10850 10715 10557 10426 10307 10015 9816 9657 9581 9418 9285 9212 9011 9041 8909 8849 8746 8745 
1 25 4882 5039 5188 5421 5571 5813 5843 5844 5932 6080 6288 6398 6296 6096 6012 6222 5954 5801 5686 5549 5528 5308 5153 4882 4814 
1 24 6034 6150 6355 6392 6490 6662 6778 6961 7111 7262 7376 7529 7750 7937 8066 8253 8381 8457 8638 8819 8943 9069 9194 9271 
1 87 4022 4108 4109 4035 4075 4296 4165 4263 4297 4455 4306 4228 4242 4123 4130 4243 4401 4527 4681 4727 4900 4909 4994 5079 5096 5172 5309 5330 5395 5367 5269 5215 5097 4910 4702 4703 4704 4528 4577 4682 4472 4578 4621 4647 4579 4766 4614 4622 4597 4636 4589 4660 4705 4825 4934 5111 5125 5025 5017 4875 4786 4919 5016 4878 5041 5218 5498 5652 5657 5691 5879 5830 5829 5580 5401 5217 5203 4858 4961 4901 5066 5237 5370 5600 5779 5771 5553 
1 5 5197 4907 4610 4374 4408 
1 24 8721 8533 8317 8082 7924 7681 7444 7144 6957 6773 6567 6405 6165 6021 5902 5723 5443 5264 4969 4772 4659 4461 4233 4172 
1 16 3075 2917 2918 2919 2928 2959 2965 2960 2929 2904 3057 3132 3033 3206 3117 3004 
1 14 435 444 469 498 544 608 639 714 672 712 772 767 800 889 
1 50 10721 10662 10604 10594 10540 10768 10749 10811 10748 10767 10774 10795 10682 10794 10876 10990 10977 11106 11076 11158 11087 10984 10792 10759 10592 10747 10821 10832 10810 10809 10895 10746 10556 10669 10648 10803 10745 10698 10852 10927 10883 10960 11082 11067 11134 11224 11233 11268 11286 11291 
1 16 6200 6193 6201 5991 5949 5885 5759 5782 5594 5545 5372 5286 5107 5102 5193 5108 
1 28 558 641 727 761 827 855 856 1011 1107 1182 1216 1396 1397 1415 1653 1809 1881 1818 1957 2046 1965 2065 2087 2228 2319 2299 2238 2266 
1 15 740 886 1043 1177 1356 1367 1502 1668 1738 1824 2042 2082 2086 2085 2151 
1 7 3516 3574 3357 3267 3112 3101 3095 
1 11 3494 3641 3796 4120 4383 4493 4600 4584 4684 4733 4905 
